P#######
#XXX#XXX
X####X##
#X#XXX##
####X###
####X###
####X#X#
######XC